W W W W W W W W W W W
W N N N D N N N N N W
W N W D W N W D W N W
W N N N N N N N N N W
W D W N W D W D W N W
W N N N N N N N N N W
W N W D W N W N W N W
W N N N N N N N N N W
W D W N W N W N W N W
W N N N N N N N D N W
W W W W W W W W W W W